8,0,0,0,0,0,0,1
7,3,0,0,0,0,0,1
3,4,3,0,0,0,0,2
3,3,2,2,0,0,0,3
3,4,0,1,2,0,0,4
0,4,0,4,0,2,0,5
1,0,2,0,3,0,3,6